{
    "mazes": [
        {
            "board": "[
                ['x', '0', 'x', 'x', 'x', 'x', 'x', 'x'],
                ['x', '0', '0', '0', '0', '0', '0', 'x'],
                ['x', '0', 'x', 'x', '0', 'x', '0', 'x'],
                ['x', '0', 'x', 'x', '0', '0', 'x', 'x'],
                ['x', 'x', 'x', '0', 'x', '0', '0', 'x'],
                ['x', '0', '0', '0', '0', '0', 'x', 'x'],
                ['x', 'x', 'x', '0', 'x', 'x', 'x', 'x'],
                ['x', 'x', 'x', 'x', 'x', 'x', 'x', 'x']
            ]",
            "startPoint": "{row: 6, column: 3}",
            "direction": "up",
            "id": 1
        }
        
    ]
}